1111111111111
1110000P11001
111000C0000E1
10000000K0001
1111111111111