1111111111111
110000000110001
111000000111111
1111000001111
1111111111111