111111111111111111111
110000000000000000000
11000000000P0000E0001
110000C00000000000001
111111111111111111111