111111111111
111110000001
100000P00C01
111111111111