11111111111111111111111111111111111111111111111111111111111111111111111111111
111111111111110000000000000000PC000000000111111111111111111111111111111111111
11111111111110000000000000000000000000000111111111111111111111111111111111111
11111111111111100000111100000011110111111111110001111111111111111111111111111
1111111111111000000001000000PC00001111111111100001111111111111111111111111111
11111111111110000000010000000000011111111111110011111111111111111111111111111
11111111111111101000C01110000000010000000111111111111111111111111111111111111
11111111100010001000000000000PC0000000011111111111111111111111111111111111111
111111111100100000000000E0000000011000011111111111111111111111111111111111111
11111110000011100000100110000001111000011111111111111111111111111111111111111
11111111000000000000000000000000011100011111111111111111111111111111111111111
11111111111100000000000E00000000011100011111111111111111111111111111111111111
11111111111111100000100000100001000000111111110111111111111111111111111111111
11111111111100000001100000000000000000011111100111111111111111111111111111111
11111111111100000000111100000000011111000000000111111111111111111111111111111
11111111111111100000111110000E01111111100000000111111111111111111111111111111
11111111000000000000000000000000011111111110000111111111111111111111111111111
111111111111000000000000000000000111110000000E0001111111111111111111111111111
11111111111111100000100110000001000011111111111111111111111111111111111111111
11111111111111111111111111111111111111111111111111111111111111111111111111111