11111111111111
10V0C1110110C1
1E0000000P0001
10000000000011
11110000110111
10011101111101
11000000000001
11111100000001
11111C0000E111
11V00000000011
10000000100001
100000001V0001
1000V00V100001
11111111000001
10000000000001
10000000000001
100000000C0001
10000000000001
10000000000001
10000000E10001
1000C0V0000001
11111111111111