1111111111111111111111
111000000000110V010001
1100000C00000000000001
1111000000001101101111
11000001110000000E0001
1111000000000V00000111
1100000000000000000011
11111P11V0000000000001
10000000000000000C0001
1000001111111010000001
11100V000000E00V000111
1111111111111111111111