1111111111111111111111
1110000000001100010001
1100000C00000000000001
1111000000001101101111
11000001110000000E0001
1111000000000000000111
1100000000000000000011
11111P1100000000000001
10000000000000000C0001
1000001111111010000001
111000000000E000000111
1111111111111111111111