11111
1E001
1P001
100C1
11111
