11111
1EV01
1P001
101C1
11111
